Month,Genre,Fiction,Non-Fiction,Youth,Total Checkouts
2021-05,Romance,120,30,60,210
2021-05,Science Fiction,150,40,55,245
2021-05,Mystery,180,20,50,250
2021-05,History,70,150,40,260
2021-05,Science,50,180,45,275
2021-06,Romance,130,25,70,225
2021-06,Science Fiction,160,35,65,260
2021-06,Mystery,190,15,55,260
2021-06,History,65,155,35,255
2021-06,Science,55,185,50,290
2021-07,Romance,140,28,75,243
2021-07,Science Fiction,170,42,68,280
