Exercise Class Type,Monday,Tuesday,Wednesday,Thursday,Friday,Saturday,Bubble Size (Weekly Total)
Yoga,20,22,25,20,18,30,135
Zumba,35,30,0,40,0,45,150
Cycling,15,20,18,15,25,40,133
HIIT,30,28,0,35,0,50,143
Pilates,25,20,22,25,20,33,145
Kickboxing,40,40,0,45,0,40,165
CrossFit,30,35,32,30,28,25,180
Aqua Aerobics,22,20,25,23,18,28,136
Dance,28,25,0,30,0,35,118
Boot Camp,20,18,22,20,24,30,134
Barre,15,17,20,15,14,20,101
Spin Class,38,40,42,45,43,50,258
